1111111111
1PF00000C1
1C11111001
1000C1C001
1C11110001
1000001001
1111101001
10C0000EC1
1110C11111
1111111111
