1111111111
1P000000C1
1C11111001
1F00C1C001
1C11110001
1F00001001
1111101001
10C0000EC1
1110C11111
1111111111
