11111
1P0C1
10F01
1C0E1
11111
