1111111111
1P000F0C01
1CF0FF0E01
10F0000001
1111111111
