1111111111
1P000000C1
1CF1F1F001
1000C1C001
1C1F1F0001
100000F001
1F1F10F001
10C0000EC1
11F0CF11F1
1111111111
