111111111111111
1P0000000000C01
1CFFFFFFFF0FF01
1000000CF00FF01
1FFFFFFFF0FCF01
1C0000000000FC1
1FFFFFFFFFCFFF1
1FFFCFFFFF0FFC1
1E0000000000001
111111111111111
