111111111111111
1CF0000000000C1
10F0FFFFFFFFFF1
1000000000000F1
1FFFFFFFFF0F001
1C0000000F0FF01
1FFFFFFF0F0F001
1000CFEF0F0F0F1
10FFFF0F0F0F0C1
10FF000F0F0FFF1
10F00FFF0F00FC1
1PF000000000F01
10000FFFFFFFF01
1FFFC0000000001
111111111111111
