11111111111111111111
1C0F000F000F000F0001
1F000F000F000F000F01
1FFFFFFFFFFFFC0F0F01
1F0000000000F0FF0F01
100FFFFFFFF0F00F0F01
10FF000000F0FF0F0F01
10CF0FFFFPF0F0CF0F01
1F0F0FC0FFF0F0FFCF01
100F0FF00000F00F0F01
10FF0000FFFFFE000F01
100FFFFFFFFFFFFFFF01
1F0F000F000F000F0001
1C000F000F000F000FC1
11111111111111111111
