1111111111111111111111111111111111111111
1C000001C00000000C000000000C001C00000001
1011110101111111111111111111101011111101
10100001010C00000000000000000C10100000C1
1010111101011111111111111111111010111111
101C0000010000C00000000000C000001C000001
1011111111111111111111111111111111111101
1000000000000000000000000000000000000001
100FFF00FFF0000000F0000FFF00FFF00FFF0001
100FC000F0F0000000F0000F0F00FCF00F000001
100FFF00F0F0000000F0000F0F00FCF00F0FF001
1000CF00F0F0000000F0000F0F00FCF00F0EF001
100FFF00FFF00FFF00FFF00FFF00FCF00FFFF001
1000000000000000000000000000000000000001
10001C10001110001C10001110001C1000111001
10001110001C10001110001C10001110001C1001
1000000000000000000000000000000000000001
1011111111111111111111111111111111111111
10FC00F000F000F000F000F00CF000F000F000F1
1000F000F000F00CF000F000F000F000F000FCP1
1111111111111111111111111111111111111111
