1111111111
1P00000C01
1C11110E01
1C00000001
1111111111
