111111111111111
1P0000000000C01
1C1111111101101
1000000C1001101
11111111101C101
1C00000000001C1
1111111111C1111
1111C11111011C1
1E0000000000001
111111111111111
