111111111111111
1C10000000000C1
101011111111111
100000000000011
111111111101001
1C0000000101101
111111110101001
1000C1E10101011
1011110101010C1
101100010101111
1010011101001C1
1P1000000000101
100001111111101
1111C0000000001
111111111111111
