11111111111111111111
1C010001000100010001
11000100010001000101
1111111111111C010101
11000000000010110101
10011111111010010101
10110000001011010101
10C101111P1010C10101
110101C011101011C101
10010110000010010101
1011000011111E000101
10011111111111111101
11010001000100010001
1C0001000100010001C1
11111111111111111111
