1111111111111111111111111111111111111111
1C000001C00000000C000000000C001C00000001
1011110101111111111111111111101011111101
10100001010C00000000000000000C10100000C1
1010111101011111111111111111111010111111
101C0000010000C00000000000C000001C000001
1011111111111111111111111111111111111101
1000000000000000000000000000000000000001
1001110011100000001000011100111001110001
1001C000101000000010000101001C1001000001
10011100101000000010000101001C1001011001
1000C100101000000010000101001C10010E1001
10011100111001110011100111001C1001111001
1000000000000000000000000000000000000001
10001C10001110001C10001110001C1000111001
10001110001C10001110001C10001110001C1001
1000000000000000000000000000000000000001
1011111111111111111111111111111111111111
101C001000100010001000100C10001000100011
100010001000100C100010001000100010001CP1
1111111111111111111111111111111111111111
