1111111111
1P000000C1
1C11111001
1000C1C001
1C11110001
1000001001
1111101001
1E100000C1
1110C11111
1111111111
