1111111111
1P00000001
1011111001
1000010001
1011110001
1000001001
1111101001
1000000E01
1110011111
1111111111
